109
8
22 4 0 0 0 0 0 0 0 0 0 0 0 18 22 22 19 17 0 0 0 0 0 0 0 0 0 0 0 0 0 0 0 0 0 0 0	0 0 0 0 0 0 0 0	0 0 0 0	0 0 0 0	0 18 22	19 0 0 0 0 0 0 0 0 0 0 0 0 0 0 0 0 0 0 0 0 0 0 0 0 0 0 0 0 0 0 0 0 0 0 18 22 22	19 0 0 0 0 0 0 0 9 12 0 0 0 0 0	0
22 4 0 0 0 0 0 0 0 0 0 0 0 0 17 17 0 0 0 0 23 24 25 0 0 0 0 0 0 0 0 0 0 0 0 0 0 0 0 0 0 0 0 0 0 0 0 0 0 0 0 0 0 0 0 17 0 0 0 0 0 0 0 0 0 0 0 0 0 0 0 0 0 0 0 0 0 0 0 0 0 0 0 0 0 0 0 0 0 0 0 0 17 17 0 0 0 0 0 0 0 1 21 21 21 2 0 0 0 0
22 4 0 0 0 0 0 0 23 24 24 25 0 0 0 0 0 0 0 0 0 0 0 0 0 0 0 0 0 0 0 0 0 10 0 9 0	0 0 0 0	0 0 0 0	0 9 10 0 0 0 0 0 0 0 0 0 0 0 0 0 0 0 0 0 0 0 0 0 0 0 9 0 0 0 0 0 0 0 0 0 0 0 0 0 0 9 12	0 0 0 0	0 0 0 0	0 0 23 24 25 3 22 22 5 21 2 0 0 0
22 4 0 0 0 0 9 9 0 0 0 0 0 0 0 0 0 0 0 0 0 0 0 0 0 0 0 0 0 0 0 0 0 23 24 25	0 0 0 0 0 0 9 0 0 1 21 21 21 2 0 0 0 0 0 0 0 0 0 12 0 0 0 0 0 0 0 0 0 0 0 23 24 25 0 0 0 0 0 0 0 0 0 0 1 21 21 21 21 2 0 0 0 0 0 0 0 0 0 0 0 3 22 22 22 5 21 2 0 0
22 4 0 0 1 21 21 21 2 0	0 0 0 0	0 0 12 9 0 0 0 0 0 0 0 0 0 0 0 0 9 0 0 0 0 0 0 0 12 0 0 23 24 25 0 3 22 5 21 21 21 2 0 12 0 0 1 21 21 2 1 21 21 2 0 0 0 0 0 0 0 0 0 0 12 0 0 0	0 0 0 0	0 1 21 6 22 22 22 4 0 0	0 0 0 23 24 25 0 0 0 3 22 22 22	22 5 21	21 21
22 4 0 1 21 6 22 22 4 0	0 0 0 10 0 1 21	21 2 0 0 0 0 0 0 0 0 0 1 21 21 2 0 0 0 0 0 23 24 25 0 0	0 0 0 3 22 22 22 22 5 21 21 21 2 0 3 22 22 4 3 22 22 4 0 0 0 0 1 21 2 0 0 23 24 24 25 0 0 9 1 21 2 3 22 22 22 22 22 4 0 12 0 0 0 0 0 0 0 0 0 3 22 22 22 22 22 22 22 22
22 4 1 21 6 22 22 22 4 0 0 1 21	21 2 3 22 5 21 21 21 2 0 10 0 0	1 21 21	6 22 4 0 0 0 0 0 0 0 0 0 0 0 0 0 3 22 22 22 22 22 22 22 5 21 21 21 6 22 4 3 22 22 4 0 0 1 21 21 6 4 0 0 0 0 0 0 1 21 21 21 6 4	3 22 22	22 22 5	21 21 21 21 2 0	0 0 0 0	0 0 3 22 22 22 22 22 22	22 22
5 21 21	22 22 22 22 22 4 0 0 3 22 5 21 21 22 22 22 22 5 21 21 21 2 0 3 22 22 22 22 4 0 0 0 0 0 0 0 0 0 0 0 0 0 3 22 22 22 22 22 22 22 22 22 22 22 22 22 4 3 22 5 21 21 21 21 6 22 22 4 0 0 0 0 0 3 21 6 22 22 22 4 3 22 22 22 22 22 22 22 22 5 21 21 2 0 0 0 0 0 3 22 22 22 22 22 22 22 22
